S............#.......#...........#.....................................
.#####.#######.#####.#.#.#######.#.....#..#............................
.#.....#...#...#...#...#.#.......#.#...................................
.#.#####.#.#.###.#######.#.#######.#.#.#.#.............................
.#.......#.#.#.........#.#.....#...#.....#.............................
.###.#####.#.#####.#.###.#######.#########.............................
.........#.#.......#.#...#.........#.#.................................
#########..##.######.#.###.####.##.#.#.................................
.....#...#...#.......#.#...#...#.#.#.#.................................
.##..#.#..##.#.##.####.#.###.#.#.#.#.##................................
.........#...#.#.#.....#...#.#.#...#...#...............................
...#.###.#.###.#.#.#######.#.#..##.#.#.#.#.............................
.......#.#.#...#.#.#.......#.#...#...#...#.............................
....#..#.#.#.###.#.#.#######.##...#######..............................
.......#.#...#...#.........#...........................................
.......#.#.##.##.#######.###......##.###..#............................
.........#...#.....#...#.#.............................................
......######.#.#####...#.#....#.....#..................................
.......#.....#.#.....#.#.#.............................................
.......#.#####.#.#..##.#.#.#...........................................
.......#.#.....#.....#.#.#.............................................
......##.#.#.###.#......##................#............................
.....#...#.#.#...#...#.................................................
.....###.#.#.#.....#.#...###............#..............................
.......#...#.#.#.........#.............................................
.....#.#######.#..#......#.............................................
.............#.#.#.........#...........................................
....#.#..##....##..#.......#............#................#.............
.......................................................................
.........#.....#.......................................................
.......#...............................................................
.......................................##...........#.##.#.....#.......
.......................................................#...............
.............#.....#....................#........#........#............
...............#.....................................#.................
..........#....#..................#.....#.#.......#..####........#.....
.....................................................#.................
..................#...........#...#.......#.......#..#..#...#..........
.............................................................#.........
.............#...............#.........###..#..#.#...#.#...............
.......................#.........#.....#.#...#.......#.................
..........#..........................###.###.###...#.#.###.............
.................................#.#.#...#...#.......#.#.#.............
..............................#..#.#.#.##....#.#######.#..#.#..........
...............................#.#...#.#...#...#.....#...#.............
...............................#######.#.....#.###.#####.#...#.........
.......................................#.....#...#.....#.....#.........
...............................###.######....###.#.#.##.###..#.........
.............................#.#...#.....#...#...#.#...#.....#.#.....#.
...................#..........##.###.#.##..###..######.#.#.####...#..#.
...............................#.#...#...#.....#.......#.......#.......
..........................##...#.#.#####.#######.#####.#######.....#...
...............................#...#.#...#.......#.....#...#.#.........
.................#........###..#.##..#.###.#.####.##.###.#.#.#####.#.#.
...........................#.........#.#...#.......#.....#.#...#...#...
................#.#.#.######.....#.#.#.#.#########.######..#.#..##.##.#
.....................#...........#...#.#.....#.....#.....#...#.........
...................#.#.######......#.#.#####.#.###.#####.#######.##..#.
...................#...#...#.........#.......#.#...#...#.....#.......#.
................#####.##.#.#...#.###.#########.#####.#.#....#..###.####
.................#...#...#.#...........#.......#.....#.#...#.......#...
...................#.#.###.#..#..#...#.#.#..####.#####.#..##.#######.#.
...................#...#...#...#.....#.#.#.#.....#...#.#.......#.....#.
.................#######.###.......##.##.###.####..#.#.#########.####..
.................#...#...#.....#...#...#.....#.....#.#...........#.....
...................#.#.##..##..#..##.#.###.###.#####.#############.###.
...................#.#.#.........#...#...#.....#...#.......#...#...#.#.
................####.#.######...##.#####.#######.#.#.##..#.#.#.#.###.#.
.................#...#...#...#.#...#...#.#.......#.#.......#.#.#.#.....
.................#.#####.#.#.###.###.###.#.#######.#########.#.#.#.####
.................#.........#.....#.........#.................#...#....E
